NO ./textures/north.xpm
SO ./textures/south.xpm
WE ./textures/west.xpm
EA ./textures/east.xpm

F 120,120,120
C 40,80,140

1111111111
1000000001
1011111101
1010000101
1010110101
1000100001
1000N00001
1111111111