NO ./textures/north.xpm
SO ./textures/south.xpm
WE ./textures/west.xpm
EA ./textures/east.xpm

F 100,90,80
C 20,40,80

1111111111111111
1E00000000000001
1111011111111011
1000010000000011
1011110111111011
1000000000000011
1111111111111111